40
30
1111111111111111111111111111111111111111
1000000000000000000000000000000000000001
1000000000000000000000000000000000000001
1000000000000000011111000000000000000001
1000000000000000000111000000000000000001
1000000000000000000000000000000000000001
1000000000000000000000000000000000000001
1000000000000000000000000000000000000001
1000000000000000000000000000000000000001
1000000000000000000000000000000000000001
1000000000000000000001000000000000000001
1000000000000000000001000000000000000001
1000000000000000000001000000000000000001
1000000000000000000001000000000000000001
1000000000000000000001000000000000000001
1000000000000000000001000000000000000001
1000000000000000000001000000000000000001
1000000000000000000001000000000000000001
1000000000000000000001000000000000000001
1000000000000000000001000000000000000001
1000000000000000000001000000000000000001
1000000000000000000001000000000000000001
1000000000000000000001000000000000000001
1000000000000000000001000000000000000001
1000000000000000000000000000000000000001
1000000000000000000000000000000000000001
1000000000000000000000000000000000000001
1000000000000000000000000000000000000001
1000000000000000000000000000000000000001
1111111111111111111111111111111111111111
