80
60
11111111111111111111111111111111111111111111111111111111111111111111111111111111
10000000000000000000000000000000000000000000000000000000000000000000000000000001
10000000000000000000000000000000000000000000000000000000000000000000000000000001
10000000000000000000000000000000000000000000000000000000000000000000000000000001
10000000000000000000000000000000000000000000000000000000000000000000000000000001
10000000000000000000000000000000000000000000000000000000000000000000000000000001
10000000000000000000000000000001111111111111111111111111111111111111111111000001
10000000000000000000000000000001111111111111111111111111111111111111111111000001
10000000000000000000000000000001111111111111111111111111111111111111111111000001
10000000000000000000000000000001111111111111111111111111111111111111111111000001
10000000000000000000000000000000000000000000000000000000000000000111111111000001
10000000000000000000000000000000000000000000000000000000000000000111111111000001
10000000000000000000000000000000000000000000000000000000000000000111111111000001
10000000000000000000000000000000000000000000000000000000000000000111111111000001
10000000000000000000000000000000000000000000000000000000000000000111111111000001
10000000000000000000000000000000000000000000000000000000000000000111111111000001
10000000000000000000000000000000000000000000000000000000000000000111111111000001
10000000000000000000000000000000000000000000000000000000000000000111111111000001
10000000000000000000000000000000000000000000000000000000000000000111111111000001
10000000000000000000000000000000000000000000000000000000000000000000000000000001
10000000000000000000000000000000000000000000000000000000000000000000000000000001
10000000000000000000000000000000000000000000000000000000000000000000000000000001
10000000000001111111111111111111111111111111111111111000000000000000000000000001
10000000000001111111111111111111111111111111111111111000000000000000000000000001
10000000000001111111111111111111111111111111111111111000000000000000000000000001
10000000000000000000000000000000000000000000000000000000000000000000000000000001
10000000000000000000000000000000000000000000000000000000000000000000000000000001
10000000000000000000000000000000000000000000000000000000000000000000000000000001
10000000000000000000000000000000000000000000000000000000000000000000000000000001
10000000000000000000000000000000000000000000000000000000000000000000000000000001
11111111111111111111111100000000000000000000000000000000000000000000000000000001
11111111111111111111111100000000000000000000000000000000000000000000000000000001
11111111111111111111111100000000000000000000000000000000000000000000000000000001
10000000000000000000000000000000000000000000000000000000000000000000000000000001
10000000000000000000000000000000000000000000000000000000000000000000000000000001
10000000000000000000000000000000000000000000000000000000000000000000000000000001
10000000000000000000000000000000000000000001111111111111111111111111111111111111
10000000000000000000000000000000000000000001111111111111111111111111111111111111
10000000000000000000000000000000000000000001111111111111111111111111111111111111
10000000000000000000000000000000000000000000000000000000000000000000000000000001
10000000000000000000000000000000000000000000000000000000000000000000000000000001
10000000000000000000000000000000000000000000000000000000000000000000000000000001
10000000000000000111111111111111111111111111111111000000000000000000000000000001
10000000000000000111111111111111111111111111111111000000000000000000000000000001
10000000000000000111111111111111111111111111111111000000000000000000000000000001
10000000000000000000000000000000000000000000000000000000000000000000000000000001
10000000000000000000000000000000000000000000000000000000000000000000000000000001
10000000000000000000000000000000000000000000000000000000000000000000000000000001
10000000000000000000000000000000000000000000000000000000000000000000000000000001
10000000000000000000000000000000000000000000000000000000000000000000000000000001
10000000000000000000000000000000000000000000000000000000000000000000000000000001
10000000000000000000000000000000000000000000000000000000000000000000000000000001
10000000000000000000000000000000000000000000000000000000000000000000000000000001
11111111111111111111100000000000000000000000000000000000000000000000000000000001
11111111111111111111100000000000000000000000000000000000000000000000000000000001
11111111111111111111100000000000000000000000000000000000000000000000000000000001
10000000000000000000000000000000000000000000000000000000000000000000000000000001
10000000000000000000000000000000000000000000000000000000000000000000000000000001
10000000000000000000000000000000000000000000000000000000000000000000000000000001
11111111111111111111111111111111111111111111111111111111111111111111111111111111
